9.ox
..o...........o.......o...o
.........o..........o......
.o..o.oo...................
.o.......o...........oooo..
...ooo..o.....o.......o....
........o......o.....o.....
...........o........o.o...o
....o...o.........oo..o....
o..............o...o.......
